1111111111111111
1000000000000001
1000000000000001
1000000000000001
1000000200000001
1000000000000001
1000000000000001
1000000000020001
1111111111111111